....GGGGGGGGGGGGGGGGGGGGGGGGGG..
................................
................................
................................
................................
................................
................................
................................
................................
BBBBBBBBBBBBBBBBBBBBBBBBBBBBBBB.
................................
................................
................................
................................
................................
................................
................................
................................
................................
................................
................................
................................
................................
